11111111
1E0000C1
10000001
10P000C1
10011101
11111111
